10 20
03000000100100000000
11111000100100000000
00000000100100000000
00111111100111110000
00000000000000000000
00011111111110000000
00000000000000000000
01111000011111111100
00011110000000000000
00000000000002000000
