40 70
0000000000000000000000000000000000000000000000000000000000000000000000
0000000000000000000000000000000000000000000000000000000000000003000000
0000000000000000000000000000000000000000000000000000000000000000000000
0000000001111111111111111100000000000000000000000000000000000000000000
0000000000000000000000000000000000000000000000111111111111111111111111
0000000000000000000000000000000000000000000001000000000000001000000000
0000000000000000000000111111100000000000000010000000000000010000000000
0000000000000000000011111110000000000000000100000000000000010000000000
0000000000000000000011111110000000000000001000000000000000010000000000
0000111111111111100000000000000000000000010000000000000000010000000000
0000000000000000000000000000000000000000000000000000000000010000000000
0000000000000000000000000000000000000000000000000000000000010000000000
0000000000011111111111111111111111111111111111111111111100010000000000
0000000000000000000000000000000000000000000000000000000000000000000000
0000000000000000000000000000000000000001000000000000000000000000000000
0000000000000000000000000000000000000001000000000001111111110000000000
0000000000000000000000000000000000000000100000000010000000000000000000
0000000000000000000000000000000000000000010000000100000000000000000000
0000000000000000000000000000000000000000001000001000000000000000000000
0000000000000000000000000000000000000000000100010000000000000000000000
1111111111111110000000000000000000000000000011100000000000000000000000
0000000000000000000000000000000000000000000001000000000000000000000000
0000000000000000001111111111111111000000000001000000000000000000000000
0000000000000000000000000000000000000000000001000000000000000000000000
0000000000000000010000000000000000000000000001000000000000000000000000
0000000000000000010000000000000000000000000000000000000000000000000000
0000000000000000010000000000000000000000000000000000000000000000000000
0000000000000000010000000000000000000000000000000000000000000000000000
0000000000000000010000000000000000000000000000000000000000000000000000
1111111100000000010000000000000000111111111111111111111000000000000000
0000000000000000010000000000000000000000000000000000000100000000000000
0000000000000000010000000000000000000000000000000000000010000000000000
0000000000000000011111111111100000000000000000000000000001000000000000
0000000000000000000000000000100000000000000000000000000000100000000000
0000000000000000000000000000100000000000000000000000000000010000000000
0111111100000000000000000000100000000000000000000000000000001000000000
0000001111100000010000000000100000000000000000000000000000000000000000
0000000000100000010000000000100000000000000000000000000000000000000000
0002000000100000010000000000100000000000000000000000000000000000000000
0000000000000000010000000000000000000000000000000000000000000000000000
