40 70
0000000000000000000000000000000000000000000000000000000000000000000000
0000000000000000000000000000000000000000000000000000000000000003000000
0000000000111111111111111000000000000000000000000000000000000000000000
0000000001111111111111111100000000000000000000000000000000000000000000
0000000000000000000000000000000000000000000000001111111111111111111111
0000000000000000000000000000000000000000000000011111111111111111111111
0000000000000000000000111111111111110000000000110000000000011000000000
0000000000000000000011111110000000000000000001100000000000011000000000
0001111111111111000011111110000000000000000000000000000000011000000000
0000111111111111100000000000000000000000000000000000000000011000000000
0000000000000000000000000000000000000000000000000000000000011000000000
0000000000000000000000011111111111111111111111111111100000011000000000
0000000000011111111111111111111111111111111111111111110000011000000000
0000000000111111111111100000000000000000000000000000000000000000000000
0000000001111111111110000000000000000000000000000000000000000000000000
0000000000000000000000000000000000000001100000000011111111111000000000
0000000000000000000000000000000000000000110000000111111111110000000000
0000000000000000000000000000000000000000011000001100000000000000000000
0000000000000000000000000000000000000000001100011000000000000000000000
1111111111111100000000000000000000000000000110110000000000000000000000
1111111111111110000000000000000000000000000011100000000000000000000000
0000000000000000000111111111111111000000000001100000000000000000000000
0000000000000000001111111111111111000000000001100000000000000000000000
0000000000000000000000000000000000000000000001100000000000000000000000
0000000000000000110000000000000000000000000001100000000000000000000000
0000000000000000110000000000000000000000000000000000000000000000000000
0000000000000000110000000000000000000000000000000000000000000000000000
0000000000000000110000000000000000000000000000000000000000000000000000
1111111100000000110000000000000000000000000000000000000000000000000000
1111111100000000110000000000000000111111111111111111111000000000000000
0000000000000000110000000000000000011111111111111111111100000000000000
0000000000000000111111111111000000000000000000000000000110000000000000
0000000000000000111111111111100000000000000000000000000011000000000000
0000000000000000000000000001100000000000000000000000000001100000000000
0011111000000000000000000001100000000000000000000000000000100000000000
0011111110000000000000000001100000000000000000000000000000000000000000
0000001111100000011000000001100000000000000000000000000000000000000000
0000000001100000011000000001100000000000000000000000000000000000000000
0002000000100000011000000001100000000000000000000000000000000000000000
0000000000000000011000000000000000000000000000000000000000000000000000
