20 50
00000000000000000000000000000000000000000000000000
00000000000000011000000000000000000000000000000000
00000000000000110000000000000000000110000000000000
00000000000001100000000000000000001100000000000000
00000000000011000000000000002000011000000111111111
00000000000110000000000000000000110000000000000000
00111111111111111111111111111111100000000000000000
00000000000000000000000000000000000000000000000000
00000000000000000000000000000000000000000000000000
00000000000000000111111000011111111111100000000000
00000000000000000011000000000000000000000000000000
11111111111111000001100000000011000000000000000000
00000000010000000000110000000001100000001111111111
00000300010000000000000000000000110000000000000000
00000000010000000000001100000000011000000000000000
00000000010000000000000110000000001111111110000000
00001111110000000000000011000000000110000000000000
00000000000000000000000001100000000011000000000000
00000000000000000000000000110000000000000000000000
00000000000000000000000000000000000000000000000000
